1111111111111111111111111111111111111111111
1000000000000000000000000000000000000000001
1000000000000000000000000000000000000000001
1000000000000000000000000000000000000000001
1000000000000000000000000000000000000000001
1000000000000000000000000000000000000000001
1111111111111111111111111111111111000000001
1000000000000000000000000000000000000000001
1000000000000000000000000000000000000000001
1000000000000000000100000001000000000001001
1000000000000000000000000000000000000001001
1000000000000100000000000000000000000001001
1000000000000000000000000000000000000001001
1000000000000000000000000000000000000001001
1000000000000000000000000000000000000001001
1000001111110000000000E00000000000000001001
1000001111110000000000000000000000000001001
1000001111110000000000000000000000000001001
1000001111110000000000000000000000000001001
1000001111110000000000000000000010000001001
1000000000000000000000000000000000000000001
1000000000000000000000000000000000000000001
1000000000000000000000000000000000000000001
1000000000111111111111111100000000000000001
1000000000000000000000000000000000000000001
1000000000000000000000000000000000000000001
1000000000000000000000000000000000000000001
1000000000000000000000000000000000000000001
1000000000000000000000000011111111110000001
1111111111111111111111111111111111111111111