NO img/br_wall.xpm
SO img/br_wall.xpm

WE img/br_wall.xpm

EA img/br_wall.xpm

F 205,215,205
C 205 ,205  ,205
        
      1111
11111111111111111111111
10000000000000000000001
10000000000000000000001
1000000000000000S000001
10000000000000000000001
11111111111111111111111