NO img/br_wall.xpm
SO img/br_wall.xpm
WE img/br_wall.xpm
EA img/br_wall.xpm

F 205,215,205
C 205 ,205  ,205

11111111111111111111111111111111111
1E000000000000000000000000000000001
10101010101010101010101010101010101
10101010101010101010101010101010101
10101010101010101010101010101010101
10101010101010101010101010101010101
10101010101010101010101010101010101
10101010101010101010101010101010101
10101010101010101010101010101010101
10101010101010101010101010101010101
10101010101010101010101010101010101
10101010101010101010101010101010101
10101010101010101010101010101010101
10101010101010101010101010101010101
10101010101010101010101010101010101
10101010101010101010101010101010101
10101010101010101010101010101010101
10101010101010101010101010101010101
10101010101010101010101010101010101
10101010101010101010101010101010101
10101010101010101010101010101010101
10101010101010101010101010101010101
10101010101010101010101010101010101
10101010101010101010101010101010101
10101010101010101010101010101010101
10101010101010101010101010101010101
10101010101010101010101010101010101
10101010101010101010101010101010101
10101010101010101010101010101010101
10101010101010101010101010101010101
10101010101010101010101010101010101
10101010101010101010101010101010101
10101010101010101010101010101010101
10101010101010101010101010101010101
10101010101010101010101010101010101
10101010101010101010101010101010101
10101010101010101010101010101010101
10101010101010101010101010101010101
10000000000000000000000000000000001
11111111111111111111111111111111111