NO ./img/n.xpm
SO ./img/s.xpm
WE ./img/w.xpm
EA ./img/e.xpm

									F							 0,0,0
C 255,									25,255

                                                                                                                                                                                                        1111111111111111111111111111111111
                                                                                                                                                                                                        1000000000000000000000000000000101
                                                                                                                                                                                                        1000000000000000000000000000110001
                                                                                                                                                                                                       10011111111111111111111111111111111
                                                                                                                                                                                                      1001  
                                                                                                                                                        11111111111  11111111111111                  1001
                                                                                                                                                        10000011111 10000000000001                  1001
                                                                                                                                                        10110000001110000000000001                 1001
                                                                                                                                                        100100000000 0  000000000011              1001
                                                                                                                                                1111111110110000011111111000000000001            1001
                                                                                                                                                100000011000001110111111111111111111            1001
                                                                                                                                                1111011111111101110000001000111111              1001                 1            11111111
                                                                                                                                                1          111111111011101010010001             1001                 1             10000001
                                                                                                                                                1111    11010101110000001000111111              1001                 1             10000001
11111111111111111111111111111111111111111111111111111111111111111111111111111111111111111111111111111111111111111111111111111111111111111111111111000    0000000011000000100011111111111111111111000111111111111111111111111111111110000001
10000000000000000000000000000000000000000000000000000000000000000000000000000000000000000000000000000000000000000000000000000000000000000000000000000    0000000000000000000000                                                  0000000001          
1111111111111111111111111111111111111111111111111111111111111111111111111111111111111111111111111111111111111111111111111111111111111111111111111111010101111100000E0111111111111111111111111111111111111111111111111111111111111111111111
                                                                    101                                                                            11110111 1110111 101111000001           
                                                                    101                                                                            11111111 11111   1111100011111
                                                                    101                                                                            1111111111111111111111001
                                                                    101                                                                            1         1           1001
                                                                    101                                                                            1         1           1001
                                                                    101                                                                            1         1           1001
                                                                    101                                                                            1         1           1001
                                                                    101                                                                            1         1           1001
                                                                    101                                                                            1     111111          1001
                                                                    101                                                                            1                     1001
                                                                    101                                                                            1                     1001
                                                                    101                                                                            1                     1001
                                                                    101                                                                            1                     1001
                                                                    101                                     11                                     1                     1001
                                                                    101                                                                            1                     1001
                                                                    101                                                                            1                     1001
                                                                    101                                                                            1                     1001
                                                                    101                                                                            1                     1001
                                                                    101                                                                            1                     1001
                                                                    101                                                                            1                     1001
                                                                    101                                                                            1                     1001
                                                                    101                                                                            1                     1001
                                                                    101                                                                                                 1001
                                                                    101                                                                                                 1001
                                                                    101                                                                                                 1001
                                                                    101                                                                                                 1001
                                                                    101                                                                                                 1001
                                                                    101                                                                                                 1001
                                                                    101                                                                                                 1001
                                                                    101                                                                                                1001
                                                                     11                                                                                               1001
                                                                                                                                                                     1001
                                                                                                                                                                     1001
                                                                                                                                                                     1001
                                                                                                                                                                     1001
                                                                                                                                                                     1001
                                                                                                                                                                     1001
                                                                                                                                                                     1001
                                                                                                                                                                     1001
                                                                                                                                                                     1001
                                                                                                                                                                     1001
                                                                                                                                                                     1001
                                                                                                                                                                     1001
                                                                                                                                                                     1001
                                                                                                                                                                     1001
                                                                                                                                                                     1001
                                                                                                                                                                     1001
                                                                                                                                                                     1001
                                                                                                                                                                     1001
                                                                                                                                                                     1001
                                                                                                                                                                     1001
                                                                                                                                                                     1001
                                                                                                                                                                     1001
                                                                                                                                                                     1001
                                                                                                                                                                     1001
                                                                                                                                                                     1001
                                                                                                                                                                     1001
                                                                                                                                                                     1001
                                                                                                                                                                     1001
                                                                                                                                                                     1001
                                                                                                                                                                     1001
                                                                                                                                                                     1001
                                                                                                                                                                     1001
                                                                                                                                                                     1001
                                                                                                                                                                     1001
                                                                                                                                                                     1001
                                                                                                                                                                     1001
                                                                                                                                                                     1001
                                                                                                                                                                     1001
                                                                                                                                                                     1001
                                                                                                                                                                     1001
                                                                                                                                                                     1001
                                                                                                                                                                     1001
                                                                                                                                                                     1001
                                                                                                                                                                     1001
                                                                                                                                                                     1001
                                                                                                                                                                     1001
                                                                                                                                                                     1001
                                                                                                                                                                     1001
                                                                                                                                                                     1001
                                                                                                                                                                     1001
                                                                                                                                                                     1001
                                                                                                                                                                     1001
                                                                                                                                                                     1001
                                                                                                                                                                     1111