NO 			./img/wf_wall3.xpm

WE 															   ./img/wf_wall1.xpm
EA ./img/wf_wall6.xpm

F 82,67,64
C 145,108,105

SO 									   ./img/wf_wall4.xpm

        1111111111111111111111111
        1000000000110000000000001
        1011000001110000000000001
        1001000000D00000000000001
111111111011000001110000000000001
10000000001100000111011111D111111
11110111111111011100000010001
11110111111111D11101010010001
11000000110101011100000010001
10000000000000001100000010001
10000000000000001101010010001
11000001110101011111011110N0111
11110111 1110101 101111010001
11111111 1111111 111111111111